It is a busy one this week! The Libertines have released the long-awaited follow-up to 2015’s ’Anthems for Doomed Youth’, The Black Keys have put out their twelfth studio LP and Bob Vylan have put out their fifth album.
Head below for more new music.
Adam Wiltzie - 'Eleven Fugues for Sodium Pentothal' (Kranky)
Alice Russell - 'I Am' (Tru Thoughts)
Benson Boone - 'Fireworks & Rollerblades' (Night Street/Warner)
The Black Keys - 'Ohio Players' (Nonesuch)
Bob Vylan - 'Humble As The Sun' (Ghost Theatre)
Bryson Tiller - 'Bryson Tiller' (RCA)
Cedric Burnside - 'Hill Country Love' (Provogue/Mascot)
Conan Gray - 'Found Heaven' (Republic/UMG)
Doja Cat - 'Scarlet 2 CLAUDE' (Kemosabe/RCA)
Drahla - 'angeltape' (Captured Tracks)
Edy Forey - 'Culture Today' (So Soul)
Einstürzende Neubauten - 'Rampen (apm: alien pop music)' (Potomak)
Erra - 'Cure' (UNFD)
Fabiana Palladino - 'Fabiana Palladino' (Paul Institute)
Five Finger Death Punch - 'Afterlife (Deluxe)' (Better Noise)
Gustaf - 'Package, Pt. 2' (Royal Mountain)
Is/Ought Gap - 'SUA' (HHBTM)
Jane Weaver - 'Love in Constant Spectacle' (Fire)
J. Cole - 'Might Delete Later' (Cold World/Interscope)
Joey Pollari - 'I'll Be Romance' (Living Sign)
José James - '1978' (Rainbow Blonde)
Katie Pruitt - 'Mantras' (Rounder/Concord)
Khruangbin - 'A La Sala' (Dead Oceans)
The KVB - 'Tremors' (Invada)
The Libertines - 'All Quiet On The Eastern Esplanade' (EMI)
Marcus King - 'Mood Swings' (Republic)
Mei Semones - 'Kabutomushi' EP (Bayonet)
Melissa Aldana - 'Echoes of the Inner Prophet' (Blue Note/UMG)
Mount Kimbie - 'The Sunset Violent' (Warp)
Ohio Players - 'Observations in Time: The Johnny Brantley/Vidalia Productions' (Good Time Good Time/Omnivore)
Old 97's - 'American Primitive' (ATO)
The Pernice Brothers - 'Who Will You Believe' (New West)
Project Gemini - 'Colours & Light' (Mr Bongo)
Sheila E. - 'Bailar' (Sony)
Tony Kofi - 'Altera Vita' (BBE)
Vampire Weekend - 'Only God Was Above Us' (Columbia)
X Ambassadors - 'Townie' (Nyle)
Yellow Days - 'Hotel Heaven' (Sugar Loaf/AWAL)
Stereoboard Tour Dates
0 upcoming shows